"filename", "language", "Python", "comment", "blank", "total"
"/home/axel/workspace/contomo/contomo/__init__.py", "Python", 8, 0, 0, 8
"/home/axel/workspace/contomo/contomo/basis.py", "Python", 227, 174, 42, 443
"/home/axel/workspace/contomo/contomo/flow_model.py", "Python", 172, 170, 43, 385
"/home/axel/workspace/contomo/contomo/phantom.py", "Python", 224, 316, 50, 590
"/home/axel/workspace/contomo/contomo/projected_advection_pde.py", "Python", 85, 88, 25, 198
"/home/axel/workspace/contomo/contomo/ray_model.py", "Python", 43, 45, 7, 95
"/home/axel/workspace/contomo/contomo/sinogram_interpolator.py", "Python", 68, 66, 13, 147
"/home/axel/workspace/contomo/contomo/utils.py", "Python", 79, 124, 19, 222
"/home/axel/workspace/contomo/contomo/velocity_solver.py", "Python", 93, 124, 28, 245
"Total", "-", 999, 1107, 227, 2333