"filename", "language", "Python", "comment", "blank", "total"
"/home/axel/workspace/contomo/src/__init__.py", "Python", 0, 0, 1, 1
"/home/axel/workspace/contomo/src/basis.py", "Python", 269, 142, 63, 474
"/home/axel/workspace/contomo/src/flow_model.py", "Python", 175, 171, 44, 390
"/home/axel/workspace/contomo/src/phantom.py", "Python", 239, 28, 51, 318
"/home/axel/workspace/contomo/src/projected_advection_pde.py", "Python", 79, 88, 22, 189
"/home/axel/workspace/contomo/src/ray_model.py", "Python", 89, 0, 22, 111
"/home/axel/workspace/contomo/src/sinogram_interpolator.py", "Python", 76, 18, 13, 107
"/home/axel/workspace/contomo/src/test_advection_pde.py", "Python", 39, 0, 10, 49
"/home/axel/workspace/contomo/src/test_advection_pde_2.py", "Python", 48, 0, 13, 61
"/home/axel/workspace/contomo/src/test_fvm.py", "Python", 34, 0, 11, 45
"/home/axel/workspace/contomo/src/test_solver.py", "Python", 139, 29, 59, 227
"/home/axel/workspace/contomo/src/test_sphere_phantom.py", "Python", 67, 0, 18, 85
"/home/axel/workspace/contomo/src/test_voxel_phantom.py", "Python", 53, 1, 23, 77
"/home/axel/workspace/contomo/src/utils.py", "Python", 121, 18, 22, 161
"/home/axel/workspace/contomo/src/velocity_solver.py", "Python", 114, 8, 30, 152
"Total", "-", 1542, 503, 402, 2447